1111111
1P00001
1CE0C01
1111111
