1111111
1P000F1
100E0C1
1111111
