11111111
1P000F01
1C0E0C01
11111111
