1111111
1P00001
1CE0001
1111111
