1111111
1P01001
110E0C1
1111111
