11111111
1P0F0CF1
1CFE0C01
11111111
