111111111111111111111111
1PCF0CF0CF0CF0CF0CF00001
1C0EC000C00CF0CF0CF00001
10C0C01CF00C00CF0C000001
10000000000CF0CF0CF00001
100C000C000CF0C00CF00001
1F00C0F0000C00CF0CF00001
100000C0000000C000000F01
100000C0000000C000000F01
100000C0000000C000000F01
111111111111111111111111