11111111111
1PCF0CF0CF1
1C0EC000C01
10C0C01CF01
11111111111
